10 15
0 0
0 0 0 0 4 3 0 0 0 0
0 0 0 0 2 1 0 0 0 0
0 0 0 0 0 0 0 0 0 0
5 5 0 5 5 5 5 5 5 5
0 0 0 0 5 0 0 0 0 0
0 0 0 0 5 0 0 0 0 0
0 0 0 0 5 0 0 0 0 0
0 0 0 0 5 0 0 0 0 0
0 0 0 0 5 0 0 0 0 0
0 0 0 0 5 0 0 0 0 0
0 0 0 0 5 0 0 0 0 0
0 0 0 0 5 0 0 0 0 0
0 0 0 0 5 0 0 0 0 0
0 0 0 0 2 1 0 0 0 0
0 0 0 0 6 6 0 0 0 0
